2	1	2	2	2	2	2	3	2	2	4	0	2	0	0	2	1	2	2	2	2	2	3	2	2	4	0	2	0	0	2	1	2	2	2	2	2	3	2	2	4	0	2	0	0	2	1	2	2	2	2	2	3	2	2	4	0	2	0	0	2	1	2	2	2	2	2	3	2	2	4	0	2	0	0	2	1	2	2	2	2	2	3	2	2	4	2	1	0	9
2	1	3	2	2	3	2	3	3	2	4	3	2	0	3	2	1	3	2	2	3	2	3	3	2	4	3	2	0	3	2	1	3	2	2	3	2	3	3	2	4	3	2	0	3	2	1	3	2	2	3	2	3	3	2	4	3	2	0	3	2	1	3	2	2	3	2	3	3	2	4	3	2	0	3	2	1	3	2	2	3	2	3	3	2	4	3	1	0	10
2	1	4	2	2	4	2	3	4	2	4	4	2	0	4	2	1	4	2	2	4	2	3	4	2	4	4	2	0	4	2	1	4	2	2	4	2	3	4	2	4	4	2	0	4	2	1	4	2	2	4	2	3	4	2	4	4	2	0	4	2	1	4	2	2	4	2	3	4	2	4	4	2	0	4	2	1	4	2	2	4	2	3	4	2	4	4	1	0	9
2	1	5	-1	0	0	2	3	5	2	4	5	2	0	5	2	1	5	-1	0	0	2	3	5	2	4	5	2	0	5	2	1	5	-1	0	0	2	3	5	2	4	5	2	0	5	2	1	5	-1	0	0	2	3	5	2	4	5	2	0	5	2	1	5	-1	0	0	2	3	5	2	4	5	2	0	5	2	1	5	2	2	5	2	3	5	2	4	5	1	0	10
-1	0	0	-1	0	0	-1	0	0	-1	0	0	-1	0	0	-1	0	0	-1	0	0	-1	0	0	-1	0	0	-1	0	0	-1	0	0	-1	0	0	-1	0	0	-1	0	0	-1	0	0	-1	0	0	-1	0	0	-1	0	0	-1	0	0	1	12	8	1	13	8	1	14	8	1	15	8	-1	0	0	-1	0	0	-1	0	0	-1	0	0	-1	0	0	-1	0	0	1	0	9
-1	0	0	-1	0	0	-1	0	0	-1	0	0	-1	0	0	-1	0	0	-1	0	0	-1	0	0	-1	0	0	-1	0	0	-1	0	0	-1	0	0	-1	0	0	-1	0	0	-1	0	0	-1	0	0	-1	0	0	-1	0	0	-1	0	0	1	12	9	1	13	9	1	14	9	1	15	9	-1	0	0	-1	0	0	-1	0	0	-1	0	0	-1	0	0	-1	0	0	1	0	10
-1	0	0	-1	0	0	-1	0	0	-1	0	0	-1	0	0	-1	0	0	-1	0	0	-1	0	0	-1	0	0	-1	0	0	-1	0	0	-1	0	0	-1	0	0	-1	0	0	-1	0	0	-1	0	0	-1	0	0	-1	0	0	-1	0	0	-1	0	0	-1	0	0	-1	0	0	-1	0	0	-1	0	0	-1	0	0	-1	0	0	-1	0	0	-1	0	0	-1	0	0	1	0	9
-1	0	0	-1	0	0	-1	0	0	-1	0	0	-1	0	0	-1	0	0	-1	0	0	-1	0	0	-1	0	0	-1	0	0	-1	0	0	-1	0	0	-1	0	0	-1	0	0	-1	0	0	-1	0	0	-1	0	0	-1	0	0	-1	0	0	-1	0	0	-1	0	0	-1	0	0	-1	0	0	-1	0	0	-1	0	0	-1	0	0	-1	0	0	-1	0	0	-1	0	0	1	0	10
-1	0	0	-1	0	0	-1	0	0	-1	0	0	-1	0	0	-1	0	0	-1	0	0	-1	0	0	-1	0	0	-1	0	0	-1	0	0	-1	0	0	-1	0	0	-1	0	0	-1	0	0	-1	0	0	-1	0	0	-1	0	0	-1	0	0	-1	0	0	-1	0	0	-1	0	0	-1	0	0	-1	0	0	-1	0	0	-1	0	0	-1	0	0	-1	0	0	-1	0	0	1	0	9
-1	0	0	-1	0	0	-1	0	0	-1	0	0	-1	0	0	-1	0	0	-1	0	0	-1	0	0	-1	0	0	-1	0	0	-1	0	0	-1	0	0	-1	0	0	-1	0	0	2	0	-1	2	1	-1	2	2	-1	2	3	-1	2	4	-1	2	0	-1	2	1	-1	2	2	-1	2	3	-1	2	4	-1	2	0	-1	2	1	-1	2	2	-1	2	3	-1	2	4	-1	1	0	10
-1	0	0	-1	0	0	-1	0	0	-1	0	0	-1	0	0	-1	0	0	-1	0	0	-1	0	0	-1	0	0	-1	0	0	-1	0	0	-1	0	0	-1	0	0	-1	0	0	2	0	0	2	1	0	2	2	0	2	3	0	2	4	0	2	0	0	2	1	0	2	2	0	2	3	0	2	4	0	2	0	0	2	1	0	2	2	0	2	3	0	2	4	0	4	3	12
-1	0	0	-1	0	0	-1	0	0	-1	0	0	-1	0	0	-1	0	0	-1	0	0	-1	0	0	-1	0	0	-1	0	0	-1	0	0	-1	0	0	-1	0	0	-1	0	0	2	0	1	2	1	1	2	2	1	2	3	1	2	4	1	2	0	1	2	1	1	2	2	1	2	3	1	2	4	1	2	0	1	2	1	1	2	2	1	2	3	1	2	4	1	4	3	13
-1	0	0	-1	0	0	-1	0	0	-1	0	0	-1	0	0	-1	0	0	-1	0	0	-1	0	0	-1	0	0	-1	0	0	-1	0	0	-1	0	0	-1	0	0	-1	0	0	2	0	2	2	1	2	2	2	2	2	3	2	2	4	2	2	0	2	2	1	2	2	2	2	2	3	2	2	4	2	2	0	2	2	1	2	2	2	2	2	3	2	2	4	2	4	3	14
-1	0	0	-1	0	0	-1	0	0	-1	0	0	-1	0	0	-1	0	0	-1	0	0	-1	0	0	-1	0	0	-1	0	0	-1	0	0	-1	0	0	-1	0	0	-1	0	0	2	0	-1	2	1	-1	2	2	-1	2	3	-1	2	4	-1	2	0	-1	2	1	-1	2	2	-1	2	3	-1	2	4	-1	2	0	-1	2	1	-1	2	2	-1	2	3	-1	2	4	-1	1	0	10
-1	0	0	-1	0	0	-1	0	0	-1	0	0	-1	0	0	-1	0	0	-1	0	0	-1	0	0	-1	0	0	-1	0	0	-1	0	0	-1	0	0	-1	0	0	-1	0	0	2	0	0	2	1	0	2	2	0	2	3	0	2	4	0	2	0	0	2	1	0	2	2	0	2	3	0	2	4	0	2	0	0	2	1	0	2	2	0	2	3	0	2	4	0	1	0	9
-1	0	0	-1	0	0	-1	0	0	-1	0	0	-1	0	0	-1	0	0	-1	0	0	-1	0	0	-1	0	0	-1	0	0	-1	0	0	-1	0	0	-1	0	0	-1	0	0	2	0	1	2	1	1	2	2	1	2	3	1	2	4	1	2	0	1	2	1	1	2	2	1	2	3	1	2	4	1	2	0	1	2	1	1	2	2	1	2	3	1	2	4	1	1	0	10
-1	0	0	-1	0	0	-1	0	0	-1	0	0	-1	0	0	-1	0	0	-1	0	0	-1	0	0	-1	0	0	-1	0	0	-1	0	0	-1	0	0	-1	0	0	-1	0	0	2	0	2	2	1	2	2	2	2	2	3	2	2	4	2	2	0	2	2	1	2	2	2	2	2	3	2	2	4	2	2	0	2	2	1	2	2	2	2	2	3	2	2	4	2	1	0	9
-1	0	0	-1	0	0	-1	0	0	-1	0	0	-1	0	0	-1	0	0	-1	0	0	-1	0	0	-1	0	0	-1	0	0	-1	0	0	-1	0	0	-1	0	0	-1	0	0	-1	0	0	-1	0	0	-1	0	0	-1	0	0	-1	0	0	-1	0	0	-1	0	0	-1	0	0	-1	0	0	-1	0	0	-1	0	0	-1	0	0	-1	0	0	-1	0	0	-1	0	0	1	0	10
-1	0	0	-1	0	0	-1	0	0	-1	0	0	-1	0	0	-1	0	0	-1	0	0	-1	0	0	-1	0	0	-1	0	0	-1	0	0	-1	0	0	-1	0	0	-1	0	0	-1	0	0	-1	0	0	-1	0	0	-1	0	0	-1	0	0	-1	0	0	-1	0	0	-1	0	0	-1	0	0	-1	0	0	-1	0	0	-1	0	0	-1	0	0	-1	0	0	-1	0	0	1	0	9
-1	0	0	-1	0	0	-1	0	0	-1	0	0	-1	0	0	-1	0	0	-1	0	0	-1	0	0	-1	0	0	-1	0	0	-1	0	0	-1	0	0	-1	0	0	-1	0	0	-1	0	0	-1	0	0	-1	0	0	-1	0	0	-1	0	0	-1	0	0	-1	0	0	-1	0	0	-1	0	0	-1	0	0	-1	0	0	-1	0	0	-1	0	0	-1	0	0	-1	0	0	1	0	10
